11111111111111111111111111111111111111111111111111101111111111111111111111111111111111111111111111111
10001000001000100000001000000010000000000010000000000010000000100010001000100000100010001000000000001
10101110111010101011101010111010111111101110101111111010111110101010101010101011101010101011111111101
10100010100010001010001010001010100010001000101000001010101000101000100010101010001000100010100000101
10111010101111111010111011101110111010111011101011101110101011101111111010101010111111111110101110101
10100000100000100010001000101000100010001010100010100000101000001010001010001010100000100000101000101
10111111111110101111111110101011101111101010111110111111101111111010101111111010111011101011101110101
10001000001000100000001000101010000000100010000000100010000000000010100000000010001010001000100010001
10101010111011111111101011101010111110111110111110101011111010111110111110111111101010111110111011101
10101010001000001000101000101010000010000010000010001000001010000010001010100000101000100010001010001
10101011101111101110101110101011111011101110111011111111101011111011101010101110101011101011101011101
10101000100010101000101000100010001000100010101010000010001000100010001000101010001010001010001000101
11101110101010101010101011111110101110111010101010101010111110101110111011101011111010101110101110111
10000010101010101010100010100010100000101000001010101010100000101000100010001000001000101000100010001
10111110101010101011111110101010111110101111111011101010101111101011111010111011111111101011111011111
10001000101000101000001000001000100010000010000010001010101010001000001010100010001000001000100010001
10101011101110101110101011111111101011111110111110101110101010101111101110111010101011111110101111101
10100010101000100010100000001000001000001000100000101000100010101000100010001000100010000010100000101
10111110101110111011111111111011111111101011111010111011111010101011111011101011111110111010111110101
10000000100010001000000000001010001000001010000010100010001010101010000010001000000010100010001000101
11111110111010111111111111101010101011111010101111101110101110101010111110111111111110101111101011101
10000010101010100000001000100010101010000010101000100000100000100010001000100000001000101000001010001
10111010101011101110111010111110101011101110111010111111111111111011101011101111101011101011111011101
10001000001000000010000010000000100000001000000010000000000000000000100000001000000010000010000000001
11111111111111111111111111111111111111111111111111101111111111111111111111111111111111111111111111111
