11111111111111111111111111111111111111111111111111101111111111111111111111111111111111111111111111111
10000010000010001000000000100000000000001000000000000000001000100000100000001000100000100000100000001
10111010111110101011101111101011101111111011111110111111101010111010101110101010101011101011101111101
10001010000000100010100000001000101000000010000010000010000010000010101010101010001000001000100010001
11101011111110111110111111111010101011111110111011111010111111101111101010111011111111111110111010111
10001000100010000000001000001010101010000010001000000010100000101000100010000010001000000000100010001
10111110101011111111111011101010111011101011101111111111101110111010111011111110111011111111101111101
10100010001000000000000010101010000010001000100000000000000010001010000000001000100010000010001000101
10111011111111111111111110101011111110111111111111111111111011101011111111101110101110111010111110101
10001000000000000000000010001010100000100000001000001000001000100000001000101000100000001010100000101
11101011111111111110111110111010101010101111101011101011101110111111101010101010111111111010111010101
10001000001000000000100000100010101010100010100010001010001000001000101010100010000000100010100010101
10111011111011111011101111101110101011111010111110111011101111111010101010111111111110101110101111101
10100010001000001010001000000010001000001010000010001000100000000010101010100010000010100000101000101
11101110101111101010111011111011111111101010111111101010111111111110111010101010111011111011101010101
10101000100000001010100010001000000000001010001000001010101000000010000010101000101000001000001010001
10101011111111111010111110101111111111111010101011111010101010111111111110101111101111101111101011101
10001010000000000010100000100010001000100010100010000010100010000000100010001000000010001000101010101
11111011111111111110101111111010101010101110111111111110101111111110101011111111111010111010101010101
10000010001000000010101000101010100010001010001000000000101000000010101000100000000010100010101010101
10101110101011111010101010101010111111111011101010111111101111101110101110101011111010111010111010101
10101000100010001010100010100010000010000000101010100010001000001000101010001000100010100010000010101
10111011111110101010111110101111111010111110101110101110111011101011101011111110111110101111111110101
10000000000000101000000000100000000010000010000000100000000010001000000000000010000000001000000000001
11111111111111111111111111111111111111111111111111101111111111111111111111111111111111111111111111111
