11111111111111111111111111111111111111111111111111101111111111111111111111111111111111111111111111111
10000000100000100000000000000000101000000000100000001000000000001000100010000000101000001000000010001
10111110111010111011111110101110101011101111101011111011111010101010111010111010101011101010111011101
10001000000010001010000010100010101010100000001010000010001010101010001010101010100000100010101000001
11101111111111101110111011111010101010111111111010111110101110101011101010101010111111111010101111101
10001000000010000000100000000010001000000000100010100000100000101000100010101010000000001010100000001
10101011111011111111111110111111111111101111101010101111111111101010111010101011111111101110111110111
10101010100010000000100010100010000010001000001010100010100000101010100010001000001000100010100010001
10111010101110111110101011101010101110111010111110111010101110101110111111101111101010111010101011101
10100010100010100010001010001000101000101010100000100010001010000000100000101010001010100010001000101
10101110111010111011111010111111101011101011101111101110111011111111101011101010111010101111111110101
10100010001000000010000010100000100010001000100000100010100000100000001010000010001010001000000010101
10111010111111111110111110101110111110101110111110111010101011101111111010111111101011111011111010111
10100010000010000010000010100010000000101010100000101010001010001000001000001000001010000010001000101
10101111101010111011111010111111101111101010101111101011111010111011111111111011111010111110101111101
10101000001010001010000010001000001000000010101000001000100010001010000000000010100010000000100010001
10101010111011101010111011101011111111111010101110101110101111101010111111111110101111111111111010111
10101010001010001000100010001000100000001010100000101000100000100010100000100000101000100000000010101
10101111101010111111101110111010101111101110111110111011111110111010101110101111101010101111111010101
10100010001010000010000010100010000000100010001000100010001000100010100010100000000010001000001010101
10111010111111111011101110111111111110111011101011101110101011101110111010101111111011111011101010101
10100010000000001000101000100000100000001000100010101000101000101010001010101000100010001000100010101
10101111111110101110111011101110111111111110111110101011101111101010111010111010111110101111111110101
10000000000000100010000000001000000000000000000000100000100000000010000010000010000000100000000000001
11111111111111111111111111111111111111111111111111101111111111111111111111111111111111111111111111111
