11111111111111111111111111111111111111111111111111101111111111111111111111111111111111111111111111111
10000010000010000010000000100010000010000000001000000000100000001000000000000000100000001000100000001
11101010111010111011111010101010111011101011101111101110111111101011111110111111101110101110101110101
10001010001000101010001010101010101000101000100010001000000000001000000010000010001000100000100010101
10111011101111101010101010101010101110101110111010111111111111101111111011111010111011111111101110101
10001010001000001010100010001000100000101000100000100010001000001000001010001010100010001000001000101
10101010111011111010111111111111101111111011101111101010101011111011101010101010101110101011111011101
10101000101000000010100000100000101000000010000010001000101000001000100010101000100000100000001010001
10101111101011111110111110101110101111101110111110111111101111111110111110101110111111111111111010111
10101000001000100000000010100010001000001000100000100000101000000000001000100010101000100000100010101
11101010101110101111111010111011111011111011101111101111101011111111111011111010101010101110101110101
10001010100010101000001010001000100010000000100010100000100010001000001010100010001010001010101000001
10111010111110111011101010101110101111111011111010101110111110101011101010101111101011111010101111111
10100010100000100010100010100010100000001010000010001000100000101010100010100000101000001000001000001
11101110101111101110111111111010111110101110111111111010101111101010111110111110111111101011111011101
10101000100010000010001000001010000010100000000000000010001000001010001000100010100000001010000010101
10101011111010111010101011101011111011111011111111111111111011111011101010101010101111111110111110101
10101000100010100010100010000010000010001010001000000000100000001000100010101000101000000000000010101
10101110101110101110101111111010111110101110101111111010101111111110101110101111101011111111111010101
10101000101000101000101000001010000010100010100000001010001000000010101000100000100000100010000000101
10101011101111101110101011101011111010111010111111101110111011111010101011111110101111101011111111101
10001000001000100010101010101010001010001010000010100010001000100010101010001000101000001000100010001
10111111111010111010111010101110101011101011111010111011111110101110101010101011111011111110101010101
10000000000010000010000000100000100000001000000010000000000000100000101000100000000010000000001000101
11111111111111111111111111111111111111111111111111101111111111111111111111111111111111111111111111111
