11111111111111111111111111111111111111111111111111101111111111111111111111111111111111111111111111111
10000010001000000000000000001000000000000010000010001000100000000000000000001000000010000000001000001
10101110101011111111111011101111111011111011101010101010101111111110111011111011101110111110101011111
10100000100000001010000010101000001010001000001010100010100000100010001000001000100000000010101000001
10111110111111101010111110101011101011101111111010111110111111101011111111101110111111111110101111101
10100010001000100010100000100010100010001000001010101000000010001000000000000010100010000000100000001
10101011111010111110101111111110111110111011101010101011111010111111111111111010101010111110111111101
10101000001010000010100010000000100000000000100010100010001000100000000010100010001010001000100010001
11101111101011111010111010101011101111111111101110101110101111101111111010101111111011101111101011101
10001000001000101000100010101010000000001000100000100010100000000010001010101000001010001000001000101
10111110111110101111101110101110111111101010111111111010111111111110101010101011101010111011111110101
10000010001000100010000000100000101000101010000000100010001000001000101010001010001010100000001000101
10111011101011101110111111111110101010111011111110111111101111101011101010111010111010101111111011111
10001000100010000010100000000010001010001000001010100000100000001010000010000010001010001010001010001
11111110111110111010101111111010111011101111101010101110111111101010111111111111101011111010101010111
10001000100010100010101000001010100010100000001010001010001000001010100000001000001000100010101010001
10101011101011101110101011101011101110111111111011111010111011111011101111101110111110101010101011101
10100010001000100000100010001000001000001000001000000010000010000010001000100010000010001010100010101
10111110111110111111111110111111111011101011101111111011111110111110111110111011111111111010111010101
10001000100010000000000010100000000010101010001000100010000010000010000000101000000000001010001000101
11101011101111111110101110101011111110101010111010101110101111111011111110101111111110111011101011101
10001000100000000010101000101000000010100010001010100000100000001000001000100000000010100010101010001
10111110111111101010111011111111111010111111101010111111111110101111101011101111111010101110101110111
10000000000000001010000000000000000010000000000010000000000000100000100000001000000010000000100000001
11111111111111111111111111111111111111111111111111101111111111111111111111111111111111111111111111111
