11111111111111111111111111111111111111111111111111101111111111111111111111111111111111111111111111111
10000000000010000000100000000000100000000010000000001000000000000000000010000000000010000000100000001
10101111111010111010101111111110101011111010111011101011101111111011111110111110111110101110101011111
10101000001010100010001000001000101010001010001010001000100000001010000010001000100000101000101000001
11101011111011101111111010101011101010101111101011111110111111101110111010111010101111101011111110101
10001000000000001000000010101010001000100000001000000010000010100010001000100010101010001010000010101
10111011111111111011111110101010111111111111111111101111111010111011101111101011101010111011101011101
10100010001000001010000010101010100010100000000010001000000010001000000000101010001010001000001000101
10111110101011111011111010111010101010101111101110101011111110111111111111101010111011101111111110101
10000000101000001000000010001010001010101010001000101000100000100000001000001010000000100010000010001
10111111101011101111111011101011111010101010111011101110101111101111101011101111111110111010111011101
10100010101010101000001000100010001010000010001000100010100000100000101010001000100010100010101010001
10101010101010101010111110111111101011111011101110111110111110111110101010111010101010101110101010111
10101000101000100010000010001000001000100010000010100000100000000010100010001010101010101000001000101
10101111101110111111111011101011111110111010111110101111101111111010111011111010101010101111101111101
10001000001000000000001000000010000010001010001000100010001010001010100010001010001000100000100010001
11101010111111111110111111111110101111101111101011111010111010101010111110101011111111111110111110111
10001010100000100010100000100000100010001000001000000010001000100010001000101010000000100000100000101
10111010101110101110101110101111111010111011101111111110101011111111101011101011101011101110101111101
10001010101010100000101000101000000010100010001000000010101010000010101010001010001010001000100000101
10111010101010101111101011101011111110101010111111101110101010111010101010111010111010111111111110101
10100010100010100000101000001000000000101010100000100000101000100010100010001010001010000010000000101
10101111111010111111101111111111111111111010101110111111101111101110111111101011101011111010111111101
10100000000010000000000000000000000000000010001000000000001000000000000000100000001000001000000000001
11111111111111111111111111111111111111111111111111101111111111111111111111111111111111111111111111111
