11111111111111111111111111111111111111111111111111101111111111111111111111111111111111111111111111111
10000010000000000000000000000010000000000000101000001010000000000000100000000010000000100010000000001
10111110111110111111101111111110111111111010101010101010111011111110111011111110111110101010111011101
10000000100010001000001000100000101000000010100010100010101000001010100010000010001010001000101010001
10111111111011101011111010101111101011111110111110111010101111101010101110111011101011111111101011101
10001000000010001010000010101000001000100000100000100010001000001000100010101000101000100000001000101
11101011111010111010111110101111101110101111101111111111101011111011101010101110101010101011101110101
10001000100010001010100010101000000010100010001000100000001010001000101010100010101010001010000010101
10111110101111101010101110101011111010111011101010101111111010101110111010101010101111111010111110101
10000000101000001010001000101010001010001000101010001000001000101000000010001010101000000010100000101
11111111101011101111101011101010101011101110101011111011101111101111111011101110101011111110101111101
10000010101010101000101000001000101000101000001000100010001000100010001010001000100010000010101000001
11101010101010101010101111111111101110101111111110111110101110111011101010111011111110111110101011111
10001000101010001010101010000000101000100000100010001000100010001000100010101000001000000000101010101
10111111101011111010101010101110101011111110101011101011111011101110111010101111101011111111101010101
10000000001000000010001000101000101000101000101000100010001000000010001010100010100010000000101000101
10111111111111111111111111101011101110101011101011111110101111111011101010101010111111111011101111101
10100000100000000000000000101000001010101000001010000010100000100010001010101000000000001000100000101
10101110111111111110111110101111111010101111111010111010111110101110111110101111111111101110111110101
10101010000000100010100010001010000000100000001010101000100010001000100000101000100010001000100010001
10101011111110101010101111111010111111111010111010101111101011111010101111101010111010111010111011111
10001000000010001010100000000000100010001010001000100000001010000010101000001010000010100010000010001
11111011111011111010101111111111101010101111101111111111101010111111101110111011111110111011111010101
10000000001000000000100000000000001000100000000000000000001010000000000000100000000000000010000000101
11111111111111111111111111111111111111111111111111101111111111111111111111111111111111111111111111111
