11111111111111111111111111111111111111111111111111101111111111111111111111111111111111111111111111111
10000000001000000000100000000000000000100000000000000000000000100000000000100000100000000000100000001
10111011111011111010101011111111111111101111111111111011111110101110111110111010101111111010111010111
10001000000010001010101010000000000000100010001000001000000010001000100010001010101000100010001010001
11101111101111101011101010111111111110111011101010101111111011111111101011101011101010101111101011101
10001000100010001000101000100010000010001000100010101000001000100000101000101010001010100010001000101
10111010111010111110101111101011101011101110101110111010101110101110101110101010111010111010111111101
10100010101010001000101000001000001010100010100010001010100010001010000010100010000010100010000000001
10101110101011101011101010111111111010101110111011101010111011111011111110111111111110101111111111101
10101010100000001010001010100000001000100000101010100010001010000010000000100000000000100000001000001
11101010111111111010111010101111111110111111101010111111101011101010111111101111111111111111101011111
10001000000000001010100010101000000000000010001010000000101000001010000000001000001000100000101010001
10111011111111101010111110101011111111111011101011101110101111111011111110111110101010101110101110101
10100010001010000010100000100010000000001000001000101000101000001010000010100000101010101010001000101
10111110101010111110101110111110111111101111111110101011101011111010111010111010111010101010111011111
10100000101000001000101000100010100000100000100000101010001000000010001010000010100010001000100010001
10101111101111111011101111101010111011111110101111101010111110111111101011101111101110111111101111101
10101000101000001010000000001000000010000010001000001010100010100000001010001000001000100000001000001
10101010101011101011111111111111111010111010111011111110101011101111111011111011111011101111111010101
10001010101010100010000000000010000010100010001010000010101000001000001000001000100010001000001010101
10111011101010111110111111111010111110111011101010111010101011111011101111101110101110111110101010111
10001000100010000010100000001010000010001010000010001000101010001010100010000000101000100010100010001
11101110111111101010101011111011111111101011111111101110101110101010111011111111111011101011111111101
10000000000000001000101000000000000000001000000000001000100000100000001000000000000000001000000000001
11111111111111111111111111111111111111111111111111101111111111111111111111111111111111111111111111111
