11111111111111111111111111111111111111111111111111101111111111111111111111111111111111111111111111111
10000000100000000000000000100010100000000010000000000010000010001000001000000000000000000010000000001
10111111101111111010111110101010101110111011101111111010111010101010111011111111101111111110101111101
10000000100010001010100010001000100010001010001000100010001000100010001000000010001000001000101000101
10111110111010101011101011111011111011101010111011101111101111111111101111111010111011101011101110101
10000010100000101000001000100010000010001000100010001000101000100000100000001010000000100010001000101
11111010101111111111111110111010111110111111101010111010101011101110101110101011111111111110111010101
10001010001000000000000010001010000010001000001000100010100010001000100010101000100010000000100010101
10101011111011111111111011101111111011101011111111101110101110111011111010111110101110111111101011101
10100000001000000010001000100000100000101010000000000010101000101010100010000010001000100000101000101
11111111101111111010111110101011101111101010111111101010111011101010101111101111101011111010111110101
10000000100010000010001000101000001000101010100000101010001000101010100000101000101010000010100000101
10111110111110111111101011111110111010101011101110111011101010101010111110101010101010101110101111101
10100010000000101000001000000010100010001010001010000010001010101010000010100010001010101010100010001
11101111111111101010101111111010101111111010111011111110111110101011101010111111111011101010111010111
10100000101000001010101000100010101000001000100000100010000000101000101010001000001010001010000010101
10101010101010111010111010101111101011101111101010101111111111101110101111101010101010111010111110101
10001010001010000010000010101000001000100000101010001000000000000010100000101010101010001010100000101
11111011101011111111111110101011111110111111101011111010111011111110101110101110101011101010101111101
10000010001010001000000010001000000010000010001000000010001010000000100010000000101000101000101000001
10111111101010111011101011111111111010111010111111111111101110111111111111111111101110101011101111101
10000000101010000010001010000000100010100010100000100000100010100010001000000010000010101000101000001
10111110111011111110111011101110101110101110101110111110111010101010101011111011111110101111101011101
10000010000000000000100000001000001000100000001000000000001000001000100010000000000000100000000010001
11111111111111111111111111111111111111111111111111101111111111111111111111111111111111111111111111111
