11111111111111111111111111111111111111111111111111101111111111111111111111111111111111111111111111111
10001000000010000000000000000000000000001000001000000000100000000010000000000010000010100000100000001
11101011101110111111111111111110101111111010111010111111101111101010111111111011101010101010111110101
10001000100010101000001000100000101000000010001010000000001000101010000000001010001010101010000000101
10111110111010101010101010101111111011111111101011111111111010101010111111101010111010101011111111101
10100010101000100010100010100000000010000000100000001000100010001010000000101000101010101000001000101
10101010101111111110111110111111111111101110111111111010101111111011111111101111101010101111101011101
10001010100010000010100000100010000000101010000010000010100010001000001000001010000000100000101000001
10111010101011101010101111101011101110101011111010111110111011101111101011111010111110111110101110111
10101000101010001000100000101000001010001000000010001010000010000000100010000010100010000010100010001
10101111101010111111111110101111111011111011111110101011111110111111111110111110101011111110111011101
10000000001000101000001000100000100000001000100010101000000010000000000010000000101000100000100010001
11111111111111101011101011111110101111111110101011101011111010111110111110111111101110101111101110111
10000000100000001010101010000000101000001000101000001010001010000010001000100000100010001000001000101
10111111101110111010101010111111101011101011101111111010101111111011101011101110111011111011111111101
10000000000010100010100010100010000010100010100000001010100010001000100000101010001000001000000010001
11111110111110101110111110111010111110111110111111101010111010101110111110101010101111101111111010111
10000010001000101000001000001010001000000000101000001010101000100000100010101010101000101000001000101
10111011111011101011101111101011101010111110101011111010101111111111101010101010111010101110101111101
10001000001010001010100010001000101010100010101000100000100000000000101010100010000010101000101000001
10101111101010111010111010111010101110101110101110111110101111111111101010111011111110101011101010101
10101000100010100010001000101010001000100010100010000010001000100000001010100010001000100010101010101
10101010111110101110101111101011111011101010111011111011111010101111111011101110101011111110101110101
10100010000000001000100000000000000010001000000000001000000010000000001000000000101000000000000000101
11111111111111111111111111111111111111111111111111101111111111111111111111111111111111111111111111111
